"district","state","Population","Area","Growth","Literacy","Sex_Ratio","Literate","Illiterate","Male","Female","Prev_Population"
"Nicobars","Andaman And Nicobar Islands",36842,1841,-12.42,78.06,777,28759,8083,20733,16109,42067
"North And Middle Andaman","Andaman And Nicobar Islands",105597,3736,-0.02,83.91,925,88606,16991,54856,50741,105618
"South Andaman","Andaman And Nicobar Islands",238142,2672,14.23,89.13,871,212256,25886,127281,110861,208476
"Rangareddy","Andhra Pradesh",5296741,7493,48.16,75.87,961,4018637,1278104,2701041,2595700,3575014
"Medak","Andhra Pradesh",3033288,9699,13.6,61.42,992,1863045,1170243,1522735,1510553,2670148
"Nizamabad","Andhra Pradesh",2551335,7956,8.77,61.25,1040,1562693,988642,1250654,1300681,2345624
"Srikakulam","Andhra Pradesh",2703114,5837,6.52,61.74,1015,1668903,1034211,1341496,1361618,2537659
"Adilabad","Andhra Pradesh",2741239,16105,10.18,61.01,1001,1672430,1068809,1369935,1371304,2487964
"West Godavari","Andhra Pradesh",3936966,7742,3.51,74.63,1004,2938158,998808,1964554,1972412,3803464
"Khammam","Andhra Pradesh",2797370,16029,8.47,64.81,1011,1812975,984395,1391034,1406336,2578934
"Krishna","Andhra Pradesh",4517398,8727,7.87,73.74,992,3331129,1186269,2267770,2249628,4187817
"Hyderabad","Andhra Pradesh",3943323,217,2.97,83.25,954,3282816,660507,2018077,1925246,3829584
"Mahbubnagar","Andhra Pradesh",4053028,18432,15.34,55.04,977,2230787,1822241,2050090,2002938,3513983
"Kurnool","Andhra Pradesh",4053463,17658,14.85,59.97,988,2430862,1622601,2038965,2014498,3529354
"Karimnagar","Andhra Pradesh",3776269,11823,8.15,64.15,1008,2422477,1353792,1880612,1895657,3491696
"Anantapur","Andhra Pradesh",4081148,19130,12.1,63.57,977,2594386,1486762,2064314,2016834,3640632
"Chittoor","Andhra Pradesh",4174064,15152,11.43,71.53,997,2985708,1188356,2090167,2083897,3745907
"Visakhapatnam","Andhra Pradesh",4290589,11161,11.96,66.91,1006,2870833,1419756,2138878,2151711,3832252
"Warangal","Andhra Pradesh",3512576,12846,8.21,65.11,997,2287038,1225538,1758926,1753650,3246073
"East Godavari","Andhra Pradesh",5154296,10807,5.16,70.99,1006,3659035,1495261,2569440,2584856,4901385
"Sri Potti Sriramulu Nellore","Andhra Pradesh",2963557,13076,11.05,68.9,985,2041891,921666,1492976,1470581,2668669
"Vizianagaram","Andhra Pradesh",2344474,6539,4.23,58.89,1019,1380661,963813,1161206,1183268,2249327
"Guntur","Andhra Pradesh",4887813,11391,9.47,67.4,1003,3294386,1593427,2440246,2447567,4464979
"YSR","Andhra Pradesh",2882469,15359,10.79,67.3,985,1939902,942567,1452125,1430344,2601741
"Prakasam","Andhra Pradesh",3397448,17626,11.05,63.08,981,2143110,1254338,1715017,1682431,3059386
"Nalgonda","Andhra Pradesh",3488809,14240,7.41,64.2,983,2239815,1248994,1759359,1729450,3248123
"Upper Subansiri","Arunachal Pradesh",83448,7032,50.78,63.8,998,53240,30208,41766,41682,55344
"Kurung Kumey","Arunachal Pradesh",92076,6040,116.56,48.75,1032,44887,47189,45313,46763,42518
"West Kameng","Arunachal Pradesh",83947,7422,12.53,67.07,819,56303,27644,46150,37797,74600
"East Siang","Arunachal Pradesh",99214,3603,13.52,72.54,980,71970,27244,50108,49106,87398
"Tirap","Arunachal Pradesh",111975,2362,11.61,52.19,944,58440,53535,57600,54375,100327
"West Siang","Arunachal Pradesh",112274,8325,8.04,66.46,930,74617,37657,58173,54101,103919
"Lohit","Arunachal Pradesh",145726,5212,16.59,68.18,912,99356,46370,76217,69509,124990
"Anjaw","Arunachal Pradesh",21167,6190,14.19,56.46,839,11951,9216,11510,9657,18537
"Dibang Valley","Arunachal Pradesh",8004,9129,10.07,64.1,813,5131,2873,4415,3589,7272
"Papumpare","Arunachal Pradesh",176573,3462,44.73,79.95,980,141170,35403,89178,87395,122002
"Tawang","Arunachal Pradesh",49977,2172,28.4,59.0,714,29486,20491,29158,20819,38923
"Upper Siang","Arunachal Pradesh",35320,6590,5.87,59.99,889,21188,14132,18698,16622,33362
"Lower Dibang Valley","Arunachal Pradesh",54080,3900,7.2,69.13,928,37386,16694,28050,26030,50448
"East Kameng","Arunachal Pradesh",78690,4134,37.62,60.02,1029,47230,31460,38783,39907,57179
"Lower Subansiri","Arunachal Pradesh",83030,3508,49.0,74.35,984,61733,21297,41850,41180,55725
"Changlang","Arunachal Pradesh",148226,4662,18.18,59.8,926,88639,59587,76961,71265,125424
"Kamrup Metropolitan","Assam",1253938,955,18.34,88.71,936,1112368,141570,647695,606243,1059606
"Darrang","Assam",928500,1585,22.19,63.08,954,585698,342802,475179,453321,759882
"Kokrajhar","Assam",887142,3296,5.21,65.22,959,578594,308548,452855,434287,843211
"Barpeta","Assam",1693622,2282,21.43,63.81,953,1080700,612922,867190,826432,1394731
"Tinsukia","Assam",1327929,3790,15.47,69.66,952,925035,402894,680291,647638,1150021
"Sonitpur","Assam",1924110,5204,15.55,67.34,956,1295696,628414,983696,940414,1665175
"Sivasagar","Assam",1151050,2668,9.44,80.41,954,925559,225491,589074,561976,1051764
"Hailakandi","Assam",659296,1327,21.45,74.33,951,490055,169241,337927,321369,542854
"Golaghat","Assam",1066888,3502,12.75,77.43,964,826091,240797,543222,523666,946242
"Dhemaji","Assam",686133,3237,19.97,72.7,953,498819,187314,351323,334810,571920
"Dibrugarh","Assam",1326335,3381,11.92,76.05,961,1008678,317657,676356,649979,1185074
"Bongaigaon","Assam",738804,1093,20.59,69.74,966,515242,223562,375790,363014,612658
"Nalbari","Assam",771639,1052,11.99,78.63,949,606740,164899,395915,375724,689025
"Dima Hasao","Assam",214102,4888,13.84,77.54,932,166015,48087,110819,103283,188073
"Karimganj","Assam",1228686,1809,21.9,78.22,963,961078,267608,625923,602763,1007946
"Dhubri","Assam",1949258,2176,24.44,58.34,953,1137197,812061,998084,951174,1566424
"Jorhat","Assam",1092256,2851,9.31,82.15,962,897288,194968,556705,535551,999228
"Lakhimpur","Assam",1042137,2277,17.22,77.2,968,804530,237607,529541,512596,889044
"Chirang","Assam",482162,1923,11.34,63.55,969,306414,175748,244877,237285,433054
"Udalguri","Assam",831668,2012,9.61,65.41,973,543994,287674,421525,410143,758752
"Cachar","Assam",1736617,3786,20.19,79.34,959,1377832,358785,886481,850136,1444893
"Goalpara","Assam",1008183,1824,22.64,67.37,964,679213,328970,513331,494852,822067
"Morigaon","Assam",957423,1551,23.34,68.03,967,651335,306088,486743,470680,776247
"Kamrup","Assam",1517542,3105,15.69,75.55,949,1146503,371039,778626,738916,1311731
"Karbi Anglong","Assam",956313,10434,17.58,69.25,951,662247,294066,490166,466147,813330
"Baksa","Assam",950075,2457,10.74,69.25,974,657927,292148,481294,468781,857933
"Nagaon","Assam",2823768,3973,22.0,72.37,962,2043561,780207,1439229,1384539,2314564
"Banka","Bihar",2034763,3020,26.48,58.17,907,1183622,851141,1066997,967766,1608763
"Madhepura","Bihar",2001762,1788,31.12,52.25,911,1045921,955841,1047495,954267,1526664
"Saran","Bihar",3951862,2641,21.64,65.96,954,2606648,1345214,2022447,1929415,3248818
"Lakhisarai","Bihar",1000912,1228,24.77,62.42,902,624769,376143,526242,474670,802206
"Darbhanga","Bihar",3937385,2279,19.47,56.56,911,2226985,1710400,2060379,1877006,3295710
"Buxar","Bihar",1706352,1703,21.67,70.14,922,1196835,509517,887800,818552,1402443
"Pashchim Champaran","Bihar",3935042,5228,29.29,55.7,909,2191818,1743224,2061311,1873731,3043578
"Kishanganj","Bihar",1690400,1884,30.4,55.46,950,937496,752904,866872,823528,1296319
"Khagaria","Bihar",1666886,1486,30.19,57.92,886,965460,701426,883821,783065,1280349
"Vaishali","Bihar",3495021,2036,28.57,66.6,895,2327684,1167337,1844338,1650683,2718380
"Munger","Bihar",1367765,1419,20.21,70.46,876,963727,404038,729086,638679,1137813
"Patna","Bihar",5838465,3202,23.73,70.68,897,4126627,1711838,3077736,2760729,4718714
"Sitamarhi","Bihar",3423574,2294,27.62,52.05,899,1781970,1641604,1802830,1620744,2682631
"Siwan","Bihar",3330464,2219,22.7,69.45,988,2313007,1017457,1675284,1655180,2714315
"Purbi Champaran","Bihar",5099371,3968,29.43,55.79,902,2844939,2254432,2681057,2418314,3939868
"Purnia","Bihar",3264619,3229,28.33,51.08,921,1667567,1597052,1699437,1565182,2543925
"Katihar","Bihar",3071029,3057,28.35,52.24,919,1604306,1466723,1600328,1470701,2392699
"Muzaffarpur","Bihar",4801062,3172,28.14,63.43,900,3045314,1755748,2526875,2274187,3746732
"Bhagalpur","Bihar",3037766,2569,25.36,63.14,880,1918045,1119721,1615833,1421933,2423234
"Saharsa","Bihar",1900661,1687,26.02,53.2,906,1011152,889509,997199,903462,1508222
"Begusarai","Bihar",2970541,1918,26.44,63.87,895,1897285,1073256,1567568,1402973,2349368
"Rohtas","Bihar",2959918,3881,20.78,73.37,918,2171692,788226,1543231,1416687,2450669
"Nalanda","Bihar",2877653,2355,21.39,64.43,922,1854072,1023581,1497218,1380435,2370585
"Araria","Bihar",2811569,2830,30.25,53.53,921,1505033,1306536,1463597,1347972,2158594
"Jehanabad","Bihar",1125313,931,21.68,66.8,922,751709,373604,585491,539822,924813
"Bhojpur","Bihar",2728407,2395,21.63,70.47,907,1922708,805699,1430733,1297674,2243202
"Kaimur","Bihar",1626384,3332,26.17,69.34,920,1127735,498649,847075,779309,1289042
"Madhubani","Bihar",4487379,3501,25.51,58.62,926,2630502,1856877,2329896,2157483,3575316
"Jamui","Bihar",1760405,3098,25.85,59.79,922,1052546,707859,915924,844481,1398812
"Gopalganj","Bihar",2562012,2033,19.02,65.47,1021,1677349,884663,1267695,1294317,2152589
"Aurangabad","Bihar",2540073,3305,26.18,70.32,926,1786179,753894,1318833,1221240,2013055
"Gaya","Bihar",4391418,4976,26.43,63.67,937,2796016,1595402,2267123,2124295,3473399
"Sheikhpura","Bihar",636342,689,21.09,63.86,930,406368,229974,329711,306631,525512
"Samastipur","Bihar",4261566,2904,25.53,61.86,911,2636205,1625361,2230019,2031547,3394859
"Sheohar","Bihar",656246,349,27.19,53.78,893,352929,303317,346670,309576,515957
"Arwal","Bihar",700843,638,18.89,67.43,928,472578,228265,363508,337335,589489
"Supaul","Bihar",2229076,2425,28.66,57.67,929,1285508,943568,1155560,1073516,1732532
"Nawada","Bihar",2219146,2494,22.63,59.76,939,1326162,892984,1144480,1074666,1809627
"Chandigarh","Chandigarh",1055450,114,17.19,86.05,818,908215,147235,580556,474894,900631
"Raigarh","Chhattisgarh",2634200,7152,18.05,73.26,991,1929815,704385,1323054,1311146,2231427
"Dhamtari","Chhattisgarh",799781,4084,13.19,78.36,1010,626708,173073,397901,401880,706583
"Rajnandgaon","Chhattisgarh",1537133,8070,19.79,75.96,1015,1167606,369527,762845,774288,1283190
"Narayanpur","Chhattisgarh",139820,4653,19.16,48.62,994,67980,71840,70120,69700,117338
"Kanker","Chhattisgarh",748941,7161,15.06,70.29,1006,526431,222510,373350,375591,650913
"Raipur","Chhattisgarh",4063872,12383,34.7,75.56,984,3070662,993210,2048323,2015549,3016980
"Mahasamund","Chhattisgarh",1032754,4790,20.05,71.02,1017,733462,299292,512025,520729,860270
"Bilaspur","Chhattisgarh",2663629,8272,33.29,70.78,971,1885317,778312,1351410,1312219,1998371
"Dantewada","Chhattisgarh",533638,8298,12.08,42.12,1020,224768,308870,264177,269461,476122
"Korea","Chhattisgarh",658917,6604,12.38,70.64,968,465459,193458,334816,324101,586329
"Korba","Chhattisgarh",1206640,6598,19.25,72.37,969,873245,333395,612819,593821,1011857
"Janjgir Champa","Chhattisgarh",1619707,3853,22.94,73.07,986,1183520,436187,815562,804145,1317478
"Jashpur","Chhattisgarh",851669,5838,14.6,67.92,1005,578454,273215,424773,426896,743167
"Kabirdham","Chhattisgarh",822526,4235,40.71,60.85,996,500507,322019,412087,410439,584554
"Surguja","Chhattisgarh",2359886,15732,19.66,60.01,978,1416168,943718,1193067,1166819,1972159
"Durg","Chhattisgarh",3343872,8535,18.98,79.06,988,2643665,700207,1682028,1661844,2810449
"Bastar","Chhattisgarh",1413199,10470,17.96,54.4,1023,768780,644419,698566,714633,1198032
"Bijapur","Chhattisgarh",255230,8530,8.78,40.86,984,104287,150943,128644,126586,234630
"Dadra and Nagar Haveli","Dadra and Nagar Haveli",343709,491,55.88,76.24,774,262044,81665,193748,149961,220496
"Daman","Daman and Diu",191173,72,67.71,88.07,534,168366,22807,124624,66549,113990
"Diu","Daman and Diu",52074,39,17.77,83.46,1031,43461,8613,25640,26434,44217
"West Delhi","Delhi",136435,1166,19.46,86.98,875,118671,17764,72765,63670,114210
"North Delhi","Delhi",43709,4226,13.62,86.85,869,37961,5748,23386,20323,38469
"South Delhi","Delhi",146850,750,20.51,86.57,862,127128,19722,78867,67983,121857
"Central Delhi","Delhi",582320,21,-9.91,85.14,892,495787,86533,307780,274540,646376
"South West Delhi","Delhi",2292958,421,30.65,88.28,840,2024223,268735,1246173,1046785,1755039
"North West Delhi","Delhi",3656539,443,27.81,84.45,865,3087947,568592,1960611,1695928,2860918
"North East Delhi","Delhi",887978,61,26.78,83.09,886,737821,150157,470826,417152,700409
"New Delhi","Delhi",142004,35,-20.72,88.34,822,125446,16558,77939,64065,179117
"East Delhi","Delhi",283583,954,16.79,89.31,884,253268,30315,150522,133061,242814
"South Goa","Goa",640537,1966,8.73,87.59,986,561046,79491,322526,318011,589108
"North Goa","Goa",818008,1736,7.84,89.57,963,732690,85318,416713,401295,758539
"Rajkot","Gujarat",3804558,11198,20.02,80.96,927,3080170,724388,1974343,1830215,3169937
"Dohad","Gujarat",2127086,3642,29.98,58.82,990,1251152,875934,1068887,1058199,1636472
"Tapi","Gujarat",807022,3139,12.14,68.26,1007,550873,256149,402104,404918,719656
"Surendranagar","Gujarat",1756268,10423,15.91,72.13,930,1266796,489472,909983,846285,1515200
"Ahmadabad","Gujarat",7214225,8107,24.03,85.31,904,6154455,1059770,3788984,3425241,5816516
"The Dangs","Gujarat",228291,1766,22.26,75.16,1006,171584,56707,113804,114487,186726
"Bhavnagar","Gujarat",2880365,10034,16.63,75.52,933,2175252,705113,1490101,1390264,2469660
"Jamnagar","Gujarat",2160119,14184,13.44,73.65,939,1590928,569191,1114038,1046081,1904195
"Mahesana","Gujarat",2035064,4401,10.73,83.61,926,1701517,333547,1056627,978437,1837861
"Gandhinagar","Gujarat",1391753,2140,4.29,84.16,923,1171299,220454,723741,668012,1334503
"PanchMahal","Gujarat",2390776,5231,18.05,70.99,949,1697212,693564,1226668,1164108,2025223
"Amreli","Gujarat",1514190,7397,8.63,74.25,964,1124286,389904,770973,743217,1393897
"Banaskantha","Gujarat",3120506,10743,24.61,65.32,938,2038315,1082191,1610168,1510338,2504218
"Patan","Gujarat",1343734,5792,13.61,72.3,935,971520,372214,694436,649298,1182760
"Narmada","Gujarat",590297,2817,14.75,72.31,961,426844,163453,301018,289279,514420
"Sabarkantha","Gujarat",2428589,7394,16.62,75.79,952,1840628,587961,1244154,1184435,2082481
"Vadodara","Gujarat",4165626,7546,14.38,78.92,934,3287512,878114,2153891,2011735,3641918
"Kachchh","Gujarat",2092371,45674,32.16,70.59,908,1477005,615366,1096631,995740,1583211
"Kheda","Gujarat",2299885,3953,13.62,82.65,940,1900855,399030,1185508,1114377,2024190
"Surat","Gujarat",6081322,4549,42.24,85.53,787,5201355,879967,3403090,2678232,4275395
"Navsari","Gujarat",1329672,2246,8.15,83.88,961,1115329,214343,678058,651614,1229470
"Porbandar","Gujarat",585449,2316,9.06,75.78,950,443653,141796,300230,285219,536814
"Anand","Gujarat",2092745,3204,12.7,84.37,925,1765649,327096,1087140,1005605,1856917
"Valsad","Gujarat",1705678,3008,20.92,78.55,922,1339810,365868,887450,818228,1410584
"Junagadh","Gujarat",2743082,8831,12.05,75.8,953,2079256,663826,1404548,1338534,2448087
"Bharuch","Gujarat",1551019,6509,13.16,81.51,925,1264236,286783,805724,745295,1370642
"Faridabad","Haryana",1809733,741,32.54,81.7,873,1478552,331181,966222,843511,1365424
"Kaithal","Haryana",1074304,2317,13.55,69.15,881,742881,331423,571135,503169,946107
"Kurukshetra","Haryana",964655,1530,16.86,76.31,888,736128,228527,510940,453715,825479
"Mewat","Haryana",1089263,1507,37.93,54.08,907,589073,500190,571192,518071,789722
"Ambala","Haryana",1128350,1574,11.23,81.75,885,922426,205924,598594,529756,1014430
"Gurgaon","Haryana",1514432,1258,73.96,84.7,854,1282724,231708,816846,697586,870563
"Hisar","Haryana",1743931,3983,13.45,72.89,872,1271151,472780,931587,812344,1537180
"Panipat","Haryana",1205437,1268,24.6,75.94,864,915409,290028,646694,558743,967445
"Yamunanagar","Haryana",1214205,1768,16.57,77.99,877,946958,267247,646886,567319,1041610
"Bhiwani","Haryana",1634445,4778,14.7,75.21,886,1229266,405179,866620,767825,1424974
"Panchkula","Haryana",561293,898,19.83,81.88,873,459587,101706,299676,261617,468408
"Sonipat","Haryana",1450001,2122,13.35,79.12,856,1147241,302760,781251,668750,1279225
"Jind","Haryana",1334152,2702,12.13,71.44,871,953118,381034,713069,621083,1189826
"Rewari","Haryana",900332,1594,17.64,80.99,898,729179,171153,474358,425974,765328
"Mahendragarh","Haryana",922088,1899,13.48,77.72,895,716647,205441,486590,435498,812556
"Sirsa","Haryana",1295189,4277,15.99,68.82,897,891349,403840,682756,612433,1116639
"Fatehabad","Haryana",942011,2538,16.85,67.92,902,639814,302197,495274,446737,806171
"Karnal","Haryana",1505324,2520,18.14,74.73,887,1124929,380395,797734,707590,1274187
"Palwal","Haryana",1042708,1359,25.76,69.32,880,722805,319903,554632,488076,829125
"Rohtak","Haryana",1061204,1745,12.88,80.22,867,851298,209906,568401,492803,940117
"Jhajjar","Haryana",958405,1834,8.9,80.65,862,772954,185451,514718,443687,880078
"Hamirpur","Himachal Pradesh",454768,1118,10.19,88.15,1095,400878,53890,217073,237695,412713
"Shimla","Himachal Pradesh",814010,5131,12.67,83.64,915,680838,133172,425070,388940,722473
"Una","Himachal Pradesh",521173,1540,16.26,86.53,976,450971,70202,263752,257421,448282
"Solan","Himachal Pradesh",580320,1936,15.93,83.68,880,485612,94708,308681,271639,500578
"Mandi","Himachal Pradesh",999777,3950,10.92,81.53,1007,815118,184659,498145,501632,901350
"Sirmaur","Himachal Pradesh",529855,2825,15.54,78.8,918,417526,112329,276254,253601,458590
"Kullu","Himachal Pradesh",437903,5503,14.76,79.4,942,347695,90208,225491,212412,381582
"Kinnaur","Himachal Pradesh",84121,6401,7.39,80.0,819,67297,16824,46246,37875,78332
"Lahul and Spiti","Himachal Pradesh",31564,13841,-5.0,76.81,903,24244,7320,16586,14978,33225
"Kangra","Himachal Pradesh",1510075,5739,12.77,85.67,1012,1293681,216394,750534,759541,1339075
"Chamba","Himachal Pradesh",519080,6522,12.63,72.17,986,374620,144460,261370,257710,460872
"Bilaspur","Himachal Pradesh",381956,1167,12.05,84.59,981,323097,58859,192810,189146,340880
"Punch","Jammu and Kashmir",476835,1674,27.97,66.74,893,318240,158595,251894,224941,372615
"Rajouri","Jammu and Kashmir",642415,2630,32.93,68.17,860,437934,204481,345384,297031,483273
"Srinagar","Jammu and Kashmir",1236829,1979,20.35,69.41,900,858483,378346,650963,585866,1027693
"Kathua","Jammu and Kashmir",616435,2502,20.53,73.09,890,450552,165883,326156,290279,511437
"Pulwama","Jammu and Kashmir",560440,1086,27.0,63.48,912,355767,204673,293117,267323,441291
"Leh","Jammu and Kashmir",133487,45110,13.87,77.2,690,103052,30435,78986,54501,117228
"Kulgam","Jammu and Kashmir",424483,410,7.73,59.23,951,251421,173062,217572,206911,394025
"Doda","Jammu and Kashmir",409936,8912,28.0,64.68,919,265147,144789,213620,196316,320263
"Samba","Jammu and Kashmir",318898,904,17.01,81.41,886,259615,59283,169087,149811,272539
"Reasi","Jammu and Kashmir",314667,1719,27.04,58.15,890,182979,131688,166490,148177,247691
"Ganderbal","Jammu and Kashmir",297446,259,36.5,58.04,874,172638,124808,158723,138723,217909
"Jammu","Jammu and Kashmir",1529958,2342,12.74,83.45,880,1276750,253208,813807,716151,1357068
"Ramban","Jammu and Kashmir",283713,1329,31.99,54.27,902,153971,129742,149166,134547,214950
"Badgam","Jammu and Kashmir",753745,1361,24.14,56.08,894,422700,331045,397965,355780,607173
"Shupiyan","Jammu and Kashmir",266215,312,25.97,60.76,951,161752,104463,136451,129764,211332
"Bandipora","Jammu and Kashmir",392232,345,28.65,56.28,889,220748,171484,207640,184592,304883
"Anantnag","Jammu and Kashmir",1078692,3574,38.58,62.69,927,676232,402460,559778,518914,778389
"Kargil","Jammu and Kashmir",140802,14036,18.02,71.34,810,100448,40354,77791,63011,119304
"Kishtwar","Jammu and Kashmir",230696,1644,20.88,56.2,920,129651,101045,120154,110542,190847
"Kupwara","Jammu and Kashmir",870354,2379,33.82,64.51,835,561465,308889,474307,396047,650392
"Baramula","Jammu and Kashmir",1008039,4243,19.45,64.63,885,651496,356543,534769,473270,843900
"Udhampur","Jammu and Kashmir",554985,2637,20.78,68.49,870,380109,174876,296783,258202,459501
"Lohardaga","Jharkhand",461790,1502,26.68,67.61,985,312216,149574,232640,229150,364533
"Ranchi","Jharkhand",2914253,5097,23.98,76.06,949,2216581,697672,1495256,1418997,2350583
"Saraikela Kharsawan","Jharkhand",1065056,2657,25.47,67.7,956,721043,344013,544507,520549,848853
"Hazaribagh","Jharkhand",1734495,3555,20.65,69.75,947,1209810,524685,890855,843640,1437625
"Chatra","Jharkhand",1042886,3718,31.77,60.18,953,627609,415277,533992,508894,791444
"Gumla","Jharkhand",1025213,5360,23.16,65.73,993,673873,351340,514407,510806,832424
"Godda","Jharkhand",1313551,2266,25.35,56.4,938,740843,572708,677787,635764,1047907
"Sahibganj","Jharkhand",1150567,2063,24.01,52.04,952,598755,551812,589430,561137,927802
"Jamtara","Jharkhand",791042,1811,21.12,64.59,954,510934,280108,404832,386210,653106
"Deoghar","Jharkhand",1492073,2477,28.03,64.85,925,967609,524464,775103,716970,1165409
"Pakur","Jharkhand",900422,1811,28.33,48.82,989,439586,460836,452701,447721,701646
"Dhanbad","Jharkhand",2684487,2040,11.99,74.52,909,2000480,684007,1406227,1278260,2397077
"Giridih","Jharkhand",2445474,4962,28.41,63.14,944,1544072,901402,1257960,1187514,1904426
"Khunti","Jharkhand",531885,2535,22.32,63.86,997,339662,192223,266342,265543,434831
"Ramgarh","Jharkhand",949443,1341,13.1,73.17,921,694707,254736,494244,455199,839472
"Bokaro","Jharkhand",2062330,2883,16.01,72.01,922,1485084,577246,1073012,989318,1777717
"Garhwa","Jharkhand",1322784,4093,27.75,60.33,935,798036,524748,683609,639175,1035447
"Latehar","Jharkhand",726978,4291,29.61,59.51,967,432625,294353,369587,357391,560897
"Kodarma","Jharkhand",716259,2540,43.42,66.84,950,478748,237511,367312,348947,499414
"Dumka","Jharkhand",1321442,3761,19.42,61.02,977,806344,515098,668408,653034,1106550
"Purbi Singhbhum","Jharkhand",2293919,3562,15.68,75.49,949,1731679,562240,1176972,1116947,1982987
"Palamu","Jharkhand",1939869,4393,26.17,63.63,928,1234339,705530,1006156,933713,1537504
"Pashchimi Singhbhum","Jharkhand",1502338,7224,21.75,58.63,1005,880821,621517,749296,753042,1233953
"Simdega","Jharkhand",599578,3774,16.58,67.99,997,407653,191925,300239,299339,514306
"Bangalore Rural","Karnataka",990923,2298,16.45,77.93,946,772226,218697,509210,481713,850943
"Kodagu","Karnataka",554519,4102,1.09,82.61,1019,458088,96431,274650,279869,548540
"Bangalore","Karnataka",9621551,2196,47.18,87.67,916,8435214,1186337,5021686,4599865,6537268
"Mysore","Karnataka",3001127,6307,13.63,72.79,985,2184520,816607,1511903,1489224,2641140
"Tumkur","Karnataka",2678980,10597,3.65,75.14,984,2012986,665994,1350292,1328688,2584641
"Gulbarga","Karnataka",2566326,10954,18.01,64.85,971,1664262,902064,1302043,1264283,2174668
"Bellary","Karnataka",2452595,8461,20.99,67.43,983,1653785,798810,1236810,1215785,2027106
"Bijapur","Karnataka",2177331,10498,20.5,67.15,960,1462078,715253,1110883,1066448,1806914
"Dakshina Kannada","Karnataka",2089649,4861,10.11,88.57,1020,1850802,238847,1034480,1055169,1897783
"Raichur","Karnataka",1928812,8442,15.51,59.56,1000,1148800,780012,964406,964406,1669823
"Bagalkot","Karnataka",1889752,6552,14.4,68.82,989,1300527,589225,950102,939650,1651881
"Dharwad","Karnataka",1847023,4260,15.13,80.0,971,1477618,369405,937099,909924,1604293
"Mandya","Karnataka",1805769,4962,2.38,70.4,995,1271261,534508,905147,900622,1763791
"Hassan","Karnataka",1776421,6814,3.18,76.07,1010,1351323,425098,883792,892629,1721672
"Shimoga","Karnataka",1752753,8478,6.71,80.45,998,1410090,342663,877254,875499,1642539
"Bidar","Karnataka",1703300,5448,13.37,70.51,956,1200997,502303,870808,832492,1502426
"Belgaum","Karnataka",4779661,13433,13.41,73.48,973,3512095,1267566,2422535,2357126,4214497
"Chitradurga","Karnataka",1659456,8436,9.33,73.71,974,1223185,436271,840657,818799,1517841
"Haveri","Karnataka",1597668,4823,11.02,77.4,950,1236595,361073,819317,778351,1439081
"Davanagere","Karnataka",1945497,5924,8.63,75.74,972,1473519,471978,986560,958937,1790939
"Kolar","Karnataka",1536401,3979,10.77,74.39,979,1142929,393472,776352,760049,1387019
"Uttara Kannada","Karnataka",1437169,10277,6.17,84.06,979,1208084,229085,726210,710959,1353649
"Koppal","Karnataka",1389920,5570,16.21,68.09,986,946397,443523,699859,690061,1196042
"Chikkaballapura","Karnataka",1255104,4244,9.23,69.76,972,875561,379543,636462,618642,1149047
"Udupi","Karnataka",1177361,3582,5.85,86.24,1094,1015356,162005,562255,615106,1112292
"Yadgir","Karnataka",1174271,5270,22.81,51.83,989,608625,565646,590383,583888,956169
"Chikmagalur","Karnataka",1137961,7202,-0.26,79.25,1008,901834,236127,566714,571247,1140927
"Ramanagara","Karnataka",1082636,3516,5.05,69.22,976,749401,333235,547893,534743,1030591
"Gadag","Karnataka",1064570,4657,9.54,75.12,982,799705,264865,537119,527451,971855
"Chamarajanagar","Karnataka",1020791,5648,5.73,61.43,993,627072,393719,512188,508603,965470
"Kollam","Kerala",2635375,2483,1.94,94.09,1113,2479624,155751,1247220,1388155,2585222
"Kozhikode","Kerala",3086293,2345,7.2,95.08,1098,2934447,151846,1471064,1615229,2879005
"Alappuzha","Kerala",2127789,1415,0.88,95.72,1100,2036720,91069,1013233,1114556,2109228
"Thiruvananthapuram","Kerala",3301427,2189,2.07,93.02,1087,3070987,230440,1581901,1719526,3234473
"Kottayam","Kerala",1974551,2206,1.07,97.21,1039,1919461,55090,968392,1006159,1953647
"Malappuram","Kerala",4112920,3554,13.45,93.57,1098,3848459,264461,1960400,2152520,3625315
"Ernakulam","Kerala",3282388,3063,5.69,95.89,1027,3147482,134906,1619333,1663055,3105675
"Thrissur","Kerala",3121200,3027,4.94,95.08,1108,2967637,153563,1480645,1640555,2974271
"Kasaragod","Kerala",1307375,1989,8.58,90.09,1080,1177814,129561,628546,678829,1204066
"Wayanad","Kerala",817420,2130,4.71,89.03,1035,727749,89671,401681,415739,780651
"Idukki","Kerala",1108974,4356,-1.79,91.99,1006,1020145,88829,552829,556145,1129186
"Kannur","Kerala",2523003,2961,4.73,95.1,1136,2399376,123627,1181181,1341822,2409055
"Palakkad","Kerala",2809934,4482,7.35,89.31,1067,2509552,300382,1359426,1450508,2617544
"Pathanamthitta","Kerala",1197412,2652,-2.97,96.55,1132,1156101,41311,561638,635774,1234064
"Lakshadweep","Lakshadweep",64473,30,6.3,91.85,946,59218,5255,33131,31342,60652
"Rajgarh","Madhya Pradesh",1545814,6153,23.26,61.21,956,946193,599621,790293,755521,1254108
"Indore","Madhya Pradesh",3276697,3898,32.88,80.87,928,2649865,626832,1699532,1577165,2465907
"Gwalior","Madhya Pradesh",2032036,4560,24.5,76.65,864,1557556,474480,1090148,941888,1632157
"Seoni","Madhya Pradesh",1379131,8758,18.22,72.12,982,994629,384502,695828,683303,1166580
"Datia","Madhya Pradesh",786754,2902,18.46,72.63,873,571419,215335,420050,366704,664152
"Dhar","Madhya Pradesh",2185793,8153,25.6,59.0,964,1289618,896175,1112929,1072864,1740281
"Ratlam","Madhya Pradesh",1455069,4861,19.72,66.78,971,971695,483374,738239,716830,1215393
"Tikamgarh","Madhya Pradesh",1445166,5048,20.13,61.43,901,887765,557401,760214,684952,1203002
"Mandla","Madhya Pradesh",1054905,5800,17.97,66.87,1008,705415,349490,525351,529554,894215
"Burhanpur","Madhya Pradesh",757847,3427,19.37,64.36,951,487750,270097,388440,369407,634872
"Neemuch","Madhya Pradesh",826067,4256,13.77,70.8,954,584855,241212,422757,403310,726085
"Damoh","Madhya Pradesh",1264219,7306,16.63,69.73,910,881540,382679,661895,602324,1083957
"Anuppur","Madhya Pradesh",749237,3747,12.3,67.88,976,508582,240655,379169,370068,667175
"Shahdol","Madhya Pradesh",1066063,6205,17.39,66.67,974,710744,355319,540052,526011,908138
"Katni","Madhya Pradesh",1292042,4950,21.41,71.98,952,930012,362030,661907,630135,1064197
"Harda","Madhya Pradesh",570465,3334,20.25,72.5,935,413587,156878,294814,275651,474399
"Alirajpur","Madhya Pradesh",728999,3182,19.45,36.1,1011,263169,465830,362506,366493,610296
"Shajapur","Madhya Pradesh",1512681,6195,17.2,69.09,938,1045111,467570,780537,732144,1290683
"Narsimhapur","Madhya Pradesh",1091854,5133,14.01,75.69,920,826424,265430,568674,523180,957683
"Satna","Madhya Pradesh",2228935,7502,19.19,72.26,926,1610628,618307,1157287,1071648,1870069
"Balaghat","Madhya Pradesh",1701698,9229,13.6,77.09,1021,1311839,389859,842008,859690,1497974
"Dindori","Madhya Pradesh",704524,7470,21.32,63.9,1002,450191,254333,351910,352614,580715
"Sheopur","Madhya Pradesh",687861,6606,22.94,57.43,901,395039,292822,361842,326019,559510
"Sehore","Madhya Pradesh",1311332,6578,21.54,70.06,918,918719,392613,683698,627634,1078930
"Sidhi","Madhya Pradesh",1127033,4851,23.72,64.43,957,726147,400886,575898,551135,910955
"Umaria","Madhya Pradesh",644758,4076,24.96,65.89,950,424831,219927,330645,314113,515972
"Vidisha","Madhya Pradesh",1458875,7371,20.09,70.53,896,1028945,429930,769449,689426,1214818
"Chhattarpur","Madhya Pradesh",1762375,8687,19.51,63.74,883,1123338,639037,935940,826435,1474667
"Dewas","Madhya Pradesh",1563715,7020,19.53,69.35,942,1084436,479279,805209,758506,1308220
"Rewa","Madhya Pradesh",2365106,6314,19.86,71.62,931,1693889,671217,1224809,1140297,1973224
"Betul","Madhya Pradesh",1575362,10043,12.92,68.9,971,1085424,489938,799270,776092,1395113
"Bhopal","Madhya Pradesh",2371061,2772,28.62,80.37,918,1905622,465439,1236215,1134846,1843462
"Singrauli","Madhya Pradesh",1178273,5675,28.05,60.41,920,711795,466478,613684,564589,920166
"Raisen","Madhya Pradesh",1331597,8466,18.35,72.98,901,971799,359798,700472,631125,1125135
"Ashoknagar","Madhya Pradesh",845071,4674,22.66,66.42,904,561296,283775,443840,401231,688954
"Morena","Madhya Pradesh",1965970,4989,23.44,71.03,840,1396428,569542,1068462,897508,1592652
"Sagar","Madhya Pradesh",2378458,10252,17.63,76.46,893,1818569,559889,1256449,1122009,2021982
"Ujjain","Madhya Pradesh",1986864,6091,16.12,72.34,955,1437297,549567,1016299,970565,1711044
"Barwani","Madhya Pradesh",1385881,5427,27.57,49.08,982,680190,705691,699234,686647,1086369
"Shivpuri","Madhya Pradesh",1726050,10066,22.76,62.55,877,1079644,646406,919579,806471,1406036
"Jabalpur","Madhya Pradesh",2463289,5211,14.51,81.07,929,1996988,466301,1276977,1186312,2151156
"Bhind","Madhya Pradesh",1703005,4459,19.21,75.26,837,1281682,421323,927058,775947,1428576
"Hoshangabad","Madhya Pradesh",1241350,6703,14.49,75.29,914,934612,306738,648563,592787,1084243
"Guna","Madhya Pradesh",1241519,6390,26.97,63.23,912,785012,456507,649330,592189,977805
"Mandsaur","Madhya Pradesh",1340411,5535,13.24,71.78,963,962147,378264,682838,657573,1183690
"Chhindwara","Madhya Pradesh",2090922,11815,13.07,71.16,964,1487900,603022,1064624,1026298,1849228
"Jhabua","Madhya Pradesh",1025048,3600,30.7,43.3,990,443846,581202,515099,509949,784275
"Panna","Madhya Pradesh",1016520,7135,18.67,64.79,905,658603,357917,533606,482914,856594
"Nashik","Maharashtra",6107187,15530,22.3,82.31,934,5026826,1080361,3157801,2949386,4993612
"Nanded","Maharashtra",3361292,10528,16.86,75.45,943,2536095,825197,1729950,1631342,2876341
"Nagpur","Maharashtra",4653570,9892,14.4,88.39,951,4113291,540279,2385223,2268347,4067806
"Ahmadnagar","Maharashtra",4543159,17048,12.44,79.05,939,3591367,951792,2343042,2200117,4040518
"Mumbai City","Maharashtra",3085411,157,-7.57,89.21,832,2752495,332916,1684176,1401235,3338106
"Solapur","Maharashtra",4317756,14895,12.16,77.02,938,3325536,992220,2227944,2089812,3849640
"Jalgaon","Maharashtra",4229917,11765,14.86,78.2,925,3307795,922122,2197359,2032558,3682672
"Kolhapur","Maharashtra",3876001,7685,10.01,81.51,957,3159328,716673,1980583,1895418,3523317
"Satara","Maharashtra",3003741,10480,6.93,82.87,988,2489200,514541,1510936,1492805,2809072
"Aurangabad","Maharashtra",3701282,10107,27.76,79.02,923,2924753,776529,1924744,1776538,2897059
"Amravati","Maharashtra",2888445,12210,10.79,87.38,951,2523923,364522,1480495,1407950,2607135
"Sangli","Maharashtra",2822143,8572,9.24,81.48,966,2299482,522661,1435475,1386668,2583434
"Yavatmal","Maharashtra",2772348,13582,12.78,82.82,952,2296059,476289,1420260,1352088,2458191
"Jalna","Maharashtra",1959046,7718,21.46,71.52,937,1401110,557936,1011382,947664,1612915
"Ratnagiri","Maharashtra",1615069,8208,-4.82,82.18,1122,1327264,287805,761107,853962,1696858
"Raigarh","Maharashtra",1493984,7086,19.31,83.14,959,1242098,251886,762626,731358,1252187
"Buldana","Maharashtra",2586258,9661,15.85,83.4,934,2156939,429319,1337259,1248999,2232420
"Nandurbar","Maharashtra",1648295,5955,25.66,64.38,978,1061172,587123,833314,814981,1311710
"Bid","Maharashtra",2585049,10693,19.61,76.99,916,1990229,594820,1349191,1235858,2161232
"Thane","Maharashtra",11060148,9558,36.01,84.53,886,9349143,1711005,5864341,5195807,8131864
"Osmanabad","Maharashtra",1657576,7569,11.5,78.44,924,1300203,357373,861526,796050,1486615
"Gondiya","Maharashtra",1322507,5234,10.14,84.95,999,1123470,199037,661584,660923,1200751
"Wardha","Maharashtra",1300774,6309,5.18,86.99,946,1131543,169231,668435,632339,1236712
"Latur","Maharashtra",2454196,7157,17.97,77.26,928,1896112,558084,1272923,1181273,2080356
"Bhandara","Maharashtra",1200334,4087,5.65,83.76,982,1005400,194934,605618,594716,1136142
"Washim","Maharashtra",1197160,4898,17.34,83.25,930,996636,200524,620290,576870,1020249
"Hingoli","Maharashtra",1177345,4827,19.27,78.17,942,920331,257014,606254,571091,987126
"Chandrapur","Maharashtra",2204307,11443,6.43,80.01,961,1763666,440641,1124073,1080234,2071133
"Gadchiroli","Maharashtra",1072942,14412,10.58,74.36,982,797840,275102,541343,531599,970286
"Akola","Maharashtra",1813906,5676,11.27,88.05,946,1597144,216762,932120,881786,1630184
"Parbhani","Maharashtra",1836086,6214,20.19,73.34,947,1346585,489501,943033,893053,1527653
"Dhule","Maharashtra",2050862,7195,20.08,72.8,946,1493028,557834,1053886,996976,1707913
"Pune","Maharashtra",9429408,15643,30.37,86.15,915,8123435,1305973,4923973,4505435,7232805
"Mumbai Suburban","Maharashtra",9356962,446,8.29,89.91,860,8412845,944117,5030625,4326337,8640652
"Sindhudurg","Maharashtra",849651,5207,-2.21,85.56,1036,726961,122690,417314,432337,868853
"Tamenglong","Manipur",140651,4391,26.15,70.05,943,98526,42125,72389,68262,111495
"Ukhrul","Manipur",183998,4544,30.7,81.35,943,149682,34316,94698,89300,140779
"Imphal West","Manipur",517992,519,16.56,86.08,1031,445888,72104,255043,262949,444399
"Churachandpur","Manipur",274143,4570,20.29,82.78,975,226936,47207,138807,135336,227902
"Senapati","Manipur",479148,3271,68.94,63.6,937,304738,174410,247366,231782,283620
"Chandel","Manipur",144182,3313,21.85,71.11,933,102528,41654,74590,69592,118327
"Bishnupur","Manipur",237399,496,13.93,75.85,999,180067,57332,118759,118640,208373
"Thoubal","Manipur",422168,514,15.94,74.47,1002,314389,107779,210873,211295,364126
"Imphal East","Manipur",456113,709,15.51,81.95,1017,373785,82328,226134,229979,394869
"West Garo Hills","Meghalaya",643291,3677,24.09,67.58,984,434736,208555,324239,319052,518407
"East Garo Hills","Meghalaya",317917,2603,26.87,73.95,972,235100,82817,161216,156701,250585
"South Garo Hills","Meghalaya",142334,1887,40.95,71.72,945,102082,40252,73179,69155,100982
"Jaintia Hills","Meghalaya",395124,3819,32.1,61.64,1013,243554,151570,196286,198838,299110
"East Khasi Hills","Meghalaya",825922,2748,24.96,84.15,1011,695013,130909,410702,415220,660949
"West Khasi Hills","Meghalaya",383461,5247,29.53,77.87,980,298601,84860,193667,189794,296040
"Ri Bhoi","Meghalaya",258840,2448,34.26,75.67,953,195864,62976,132535,126305,192790
"Lawngtlai","Mizoram",117894,2557,60.14,65.88,945,77669,40225,60614,57280,73619
"Aizawl","Mizoram",400309,3576,22.92,97.89,1009,391862,8447,199258,201051,325666
"Lunglei","Mizoram",161428,4536,17.64,88.86,947,143445,17983,82911,78517,137222
"Mamit","Mizoram",86364,3025,37.56,84.93,927,73349,13015,44818,41546,62783
"Kolasib","Mizoram",83955,1382,27.28,93.5,956,78498,5457,42922,41033,65961
"Serchhip","Mizoram",64937,1421,20.56,97.91,977,63580,1357,32846,32091,53863
"Saiha","Mizoram",56574,1399,-7.34,90.01,979,50922,5652,28587,27987,61055
"Champhai","Mizoram",125745,3185,16.01,95.91,984,120602,5143,63380,62365,108392
"Wokha","Nagaland",166343,1628,98.81,87.69,968,145866,20477,84524,81819,83669
"Mon","Nagaland",250260,1786,80.36,56.99,899,142623,107637,131785,118475,138756
"Mokokchung","Nagaland",194622,1615,60.94,91.62,925,178313,16309,101102,93520,120928
"Tuensang","Nagaland",196596,2536,94.83,73.08,929,143672,52924,101916,94680,100906
"Kohima","Nagaland",267988,1463,131.81,85.23,928,228406,39582,138998,128990,115607
"Peren","Nagaland",95219,1651,104.15,77.95,915,74223,20996,49723,45496,46642
"Kiphire","Nagaland",74004,1130,38.58,69.54,956,51462,22542,37834,36170,53402
"Longleng","Nagaland",50484,562,-21.57,72.17,905,36434,14050,26501,23983,64368
"Zunheboto","Nagaland",140757,1255,78.05,85.26,976,120009,20748,71233,69524,79055
"Phek","Nagaland",163418,2026,111.84,78.05,951,127548,35870,83761,79657,77142
"Dimapur","Nagaland",378811,927,127.29,84.79,919,321194,57617,197400,181411,166664
"Baleshwar","Orissa",2320529,3806,14.62,79.79,957,1851550,468979,1185758,1134771,2024541
"Cuttack","Orissa",2624470,3932,12.1,85.5,940,2243922,380548,1352820,1271650,2341186
"Puri","Orissa",1698730,3479,13.05,84.67,963,1438315,260415,865374,833356,1502636
"Anugul","Orissa",1273821,6375,11.74,77.53,943,987593,286228,655595,618226,1139987
"Khordha","Orissa",2251673,2813,19.94,86.88,929,1956254,295419,1167275,1084398,1877333
"Gajapati","Orissa",577817,4325,11.37,53.49,1043,309074,268743,282828,294989,518826
"Kendrapara","Orissa",1440361,2644,10.63,85.15,1007,1226467,213894,717669,722692,1301962
"Debagarh","Orissa",312520,2940,14.01,72.57,975,226796,85724,158238,154282,274116
"Kandhamal","Orissa",733110,8021,13.1,64.13,1037,470143,262967,359897,373213,648196
"Koraput","Orissa",1379647,8807,16.86,49.21,1032,678924,700723,678960,700687,1180598
"Baudh","Orissa",441162,3098,18.16,71.61,991,315916,125246,221578,219584,373360
"Jharsuguda","Orissa",579505,2114,13.69,78.86,953,456998,122507,296726,282779,509724
"Nayagarh","Orissa",962789,3890,11.37,80.42,915,774275,188514,502762,460027,864496
"Balangir","Orissa",1648997,6575,23.32,64.72,987,1067231,581766,829893,819104,1337169
"Jajapur","Orissa",1827192,2899,12.49,80.13,973,1464129,363063,926098,901094,1624315
"Subarnapur","Orissa",610183,2337,12.61,74.42,960,454098,156085,311318,298865,541855
"Nabarangapur","Orissa",1220946,5291,19.03,46.43,1019,566885,654061,604728,616218,1025746
"Nuapada","Orissa",610382,3852,15.02,57.35,1021,350054,260328,302020,308362,530675
"Mayurbhanj","Orissa",2519738,10418,13.33,63.17,1006,1591718,928020,1256101,1263637,2223364
"Malkangiri","Orissa",613192,5791,21.62,48.54,1020,297643,315549,303560,309632,504187
"Ganjam","Orissa",3529031,8206,11.66,71.09,983,2508788,1020243,1779642,1749389,3160515
"Dhenkanal","Orissa",1192811,4452,11.8,78.76,947,939458,253353,612640,580171,1066915
"Sambalpur","Orissa",1041099,6624,11.27,76.22,976,793526,247573,526872,514227,935651
"Sundargarh","Orissa",2093437,9712,14.35,73.34,973,1535327,558110,1061043,1032394,1830728
"Bhadrak","Orissa",1506337,2505,12.94,82.78,981,1246946,259391,760392,745945,1333750
"Rayagada","Orissa",967911,7073,16.46,49.76,1051,481633,486278,471922,495989,831110
"Kalahandi","Orissa",1576869,7920,18.07,59.22,1003,933822,643047,787254,789615,1335537
"Jagatsinghapur","Orissa",1136971,1668,7.5,86.59,968,984503,152468,577729,559242,1057647
"Bargarh","Orissa",1481255,5837,10.02,74.62,977,1105312,375943,749244,732011,1346351
"Kendujhar","Orissa",1801733,8303,15.35,68.24,988,1229503,572230,906304,895429,1561971
"Mahe","Puducherry",41816,9,13.54,97.87,1184,40925,891,19147,22669,36829
"Yanam","Puducherry",55626,30,77.19,79.47,1038,44206,11420,27294,28332,31393
"Karaikal","Puducherry",200222,157,17.23,87.05,1047,174293,25929,97812,102410,170794
"Puducherry","Puducherry",950289,294,29.23,85.44,1029,811927,138362,468353,481936,735347
"Rupnagar","Punjab",684627,1356,8.87,82.19,915,562695,121932,357508,327119,628848
"Faridkot","Punjab",617508,1458,12.09,69.55,890,429477,188031,326724,290784,550904
"Shahid Bhagat Singh Nagar","Punjab",612310,1282,4.23,79.78,954,488501,123809,313362,298948,587460
"Fatehgarh Sahib","Punjab",600163,1180,11.46,79.35,871,476229,123934,320771,279392,538456
"Barnala","Punjab",595527,1482,13.02,67.82,876,403886,191641,317445,278082,526922
"Amritsar","Punjab",2490656,2683,15.47,76.27,889,1899623,591033,1318505,1172151,2156972
"Sangrur","Punjab",1655169,3625,12.35,67.99,885,1125349,529820,878074,777095,1473226
"Ludhiana","Punjab",3498739,3578,15.36,82.2,873,2875963,622776,1867987,1630752,3032887
"Hoshiarpur","Punjab",1586625,3386,7.11,84.59,961,1342126,244499,809090,777535,1481304
"Bathinda","Punjab",1388525,3353,17.34,68.28,868,948085,440440,743322,645203,1183335
"Moga","Punjab",995746,2242,11.28,70.68,893,703793,291953,526015,469731,894811
"Patiala","Punjab",1895686,3325,19.62,75.28,891,1427072,468614,1002478,893208,1584757
"Tarn Taran","Punjab",1119627,2414,19.23,67.81,900,759219,360408,589277,530350,939048
"Muktsar","Punjab",901896,2593,16.0,65.81,896,593538,308358,475684,426212,777497
"Firozpur","Punjab",2029074,5305,16.21,68.92,893,1398438,630636,1071883,957191,1746041
"Kapurthala","Punjab",815168,1633,8.04,79.07,912,644553,170615,426343,388825,754506
"Mansa","Punjab",769751,2198,11.76,61.83,883,475937,293814,408790,360961,688754
"Jalandhar","Punjab",2193590,2624,11.76,82.48,915,1809273,384317,1145478,1048112,1962768
"Gurdaspur","Punjab",2298323,3551,9.26,79.95,895,1837509,460814,1212835,1085488,2103536
"Hanumangarh","Rajasthan",1774692,9656,16.91,67.13,906,1191351,583341,931108,843584,1517998
"Karauli","Rajasthan",1458248,5524,20.55,66.22,861,965652,492596,783583,674665,1209662
"Jalor","Rajasthan",1828730,10640,26.21,54.86,952,1003241,825489,936849,891881,1448958
"Chittaurgarh","Rajasthan",1544338,7822,16.08,61.71,972,953011,591327,783133,761205,1330408
"Jaipur","Rajasthan",6626178,11143,26.19,75.51,910,5003427,1622751,3469203,3156975,5250953
"Jhalawar","Rajasthan",1411129,6219,19.55,61.5,946,867844,543285,725143,685986,1180367
"Pali","Rajasthan",2037573,12387,11.94,62.39,987,1271242,766331,1025452,1012121,1820237
"Pratapgarh","Rajasthan",867848,4449,22.78,55.97,983,485735,382113,437644,430204,706832
"Churu","Rajasthan",2039547,13835,6.01,66.75,940,1361398,678149,1051313,988234,1923919
"Dungarpur","Rajasthan",1388552,3770,25.36,59.46,994,825633,562919,696365,692187,1107652
"Dausa","Rajasthan",1634409,3432,24.09,68.16,905,1114013,520396,857957,776452,1317116
"Baran","Rajasthan",1222755,6992,19.68,66.66,929,815088,407667,633880,588875,1021687
"Bundi","Rajasthan",1110906,5776,15.4,61.52,925,683429,427477,577094,533812,962657
"Dhaulpur","Rajasthan",1206516,3033,22.71,69.08,846,833461,373055,653584,552932,983225
"Banswara","Rajasthan",1797485,4522,26.53,56.33,980,1012523,784962,907821,889664,1420600
"Barmer","Rajasthan",2603751,28387,32.52,56.53,902,1471900,1131851,1368954,1234797,1964799
"Sirohi","Rajasthan",1036346,5136,21.76,55.25,940,572581,463765,534199,502147,851138
"Ganganagar","Rajasthan",1969168,10978,10.04,69.64,887,1371329,597839,1043544,925624,1789502
"Jaisalmer","Rajasthan",669919,38401,31.81,57.22,852,383328,286591,361727,308192,508246
"Jhunjhunun","Rajasthan",2137045,5928,11.67,74.13,950,1584191,552854,1095921,1041124,1913715
"Bharatpur","Rajasthan",2548462,5066,21.29,70.11,880,1786727,761735,1355565,1192897,2101131
"Tonk","Rajasthan",1421326,7194,17.3,61.58,952,875253,546073,728138,693188,1211702
"Bhilwara","Rajasthan",2408523,10455,19.6,61.37,973,1478111,930412,1220742,1187781,2013815
"Sawai Madhopur","Rajasthan",1335551,4498,19.56,65.39,897,873317,462234,704033,631518,1117055
"Kota","Rajasthan",1951014,5217,24.39,76.56,911,1493696,457318,1020939,930075,1568465
"Bikaner","Rajasthan",2363937,30239,41.19,65.13,905,1539632,824305,1240912,1123025,1674295
"Rajsamand","Rajasthan",1156597,4655,17.18,63.14,990,730275,426322,581205,575392,987026
"Ajmer","Rajasthan",2583052,8481,18.4,69.33,951,1790830,792222,1323963,1259089,2181632
"Sikar","Rajasthan",2677333,7732,17.03,71.91,947,1925270,752063,1375107,1302226,2287732
"Alwar","Rajasthan",3674179,8380,22.78,70.72,895,2598379,1075800,1938881,1735298,2992490
"Jodhpur","Rajasthan",3687165,22850,27.74,65.94,916,2431317,1255848,1924408,1762757,2886461
"Udaipur","Rajasthan",3068420,11724,23.69,61.82,958,1896897,1171523,1567120,1501300,2480734
"Nagaur","Rajasthan",3307743,17718,19.2,62.8,950,2077263,1230480,1696278,1611465,2774952
"East Sikkim","Sikkim",1709346,63,15.73,83.85,873,1433287,276059,912625,796721,1477012
"South Sikkim","Sikkim",2731929,247,11.65,81.42,915,2224337,507592,1426595,1305334,2446869
"North Sikkim","Sikkim",2241624,62,6.53,78.01,767,1748691,492933,1268604,973020,2104219
"Erode","Tamil Nadu",2251744,5760,11.66,72.58,993,1634316,617428,1129826,1121918,2016608
"Theni","Tamil Nadu",1245899,2868,13.89,77.26,991,962582,283317,625765,620134,1093949
"Cuddalore","Tamil Nadu",2605914,3703,14.02,78.04,987,2033655,572259,1311482,1294432,2285489
"Thiruvarur","Tamil Nadu",1264277,2274,8.11,82.86,1017,1047580,216697,626811,637466,1169436
"Sivaganga","Tamil Nadu",1339101,4233,15.9,79.85,1003,1069272,269829,668548,670553,1155393
"Pudukkottai","Tamil Nadu",1618345,4644,10.88,77.19,1015,1249201,369144,803149,815196,1459546
"Perambalur","Tamil Nadu",565223,1756,14.5,74.32,1003,420074,145149,282188,283035,493645
"Thoothukkudi","Tamil Nadu",1750176,4745,11.32,86.16,1023,1507952,242224,865139,885037,1572203
"Tiruppur","Tamil Nadu",2479052,5187,29.11,78.68,989,1950518,528534,1246381,1232671,1920108
"Tiruvannamalai","Tamil Nadu",2464875,6188,12.75,74.21,994,1829184,635691,1236146,1228729,2186142
"Namakkal","Tamil Nadu",1726601,3420,15.61,74.63,986,1288562,438039,869386,857215,1493470
"Krishnagiri","Tamil Nadu",1879809,5129,20.41,71.46,958,1343312,536497,960066,919743,1561173
"Nagapattinam","Tamil Nadu",1616450,2569,8.57,83.59,1025,1351191,265259,798247,818203,1488855
"Kanniyakumari","Tamil Nadu",1870374,1684,11.6,91.75,1019,1716068,154306,926386,943988,1675962
"Dindigul","Tamil Nadu",2159775,6036,12.31,76.26,998,1647044,512731,1080968,1078807,1923048
"Salem","Tamil Nadu",3482056,5237,15.44,72.86,954,2537026,945030,1782014,1700042,3016334
"Tiruchirappalli","Tamil Nadu",2722290,4509,12.57,83.23,1013,2265762,456528,1352355,1369935,2418309
"Dharmapuri","Tamil Nadu",1506843,4497,16.34,68.54,946,1032790,474053,774328,732515,1295206
"Thanjavur","Tamil Nadu",2405890,3411,8.56,82.64,1035,1988227,417663,1182256,1223634,2216185
"Viluppuram","Tamil Nadu",3458873,7194,16.84,71.88,987,2486238,972635,1740751,1718122,2960350
"Thiruvallur","Tamil Nadu",3728104,3394,35.33,84.03,987,3132726,595378,1876248,1851856,2754825
"Ariyalur","Tamil Nadu",754894,1940,8.54,71.34,1015,538541,216353,374637,380257,695498
"Vellore","Tamil Nadu",3936331,6075,13.2,79.17,1007,3116393,819938,1961301,1975030,3477324
"Madurai","Tamil Nadu",3038252,3710,17.84,83.45,990,2535421,502831,1526760,1511492,2578286
"Kancheepuram","Tamil Nadu",3998252,4483,38.95,84.49,986,3378123,620129,2013219,1985033,2877475
"Karur","Tamil Nadu",1064493,2904,13.77,75.6,1015,804757,259736,528284,536209,935654
"The Nilgiris","Tamil Nadu",735394,2565,-3.51,85.2,1042,626556,108838,360134,375260,762145
"Tirunelveli","Tamil Nadu",3077233,6693,12.97,82.5,1023,2538717,538516,1521124,1556109,2723938
"Chennai","Tamil Nadu",4646732,175,6.98,90.18,989,4190423,456309,2336215,2310517,4343552
"Ramanathapuram","Tamil Nadu",1353445,4104,13.96,80.72,983,1092501,260944,682524,670921,1187649
"Virudhunagar","Tamil Nadu",1942288,4241,10.91,80.15,1007,1556744,385544,967757,974531,1751229
"Coimbatore","Tamil Nadu",3458045,4732,18.56,83.98,1000,2904066,553979,1729023,1729022,2916705
"North Tripura","Tripura",693947,2036,17.44,87.5,967,607204,86743,352795,341152,590895
"South Tripura","Tripura",876001,3057,14.15,84.66,957,741622,134379,447624,428377,767412
"West Tripura","Tripura",1725739,2993,12.57,88.69,962,1530558,195181,879582,846157,1533036
"Dhalai","Tripura",378230,2400,22.85,85.72,944,324219,54011,194563,183667,307880
"Ambedkar Nagar","Uttar Pradesh",2397888,2350,18.3,72.23,978,1731995,665893,1212279,1185609,2026955
"Pilibhit","Uttar Pradesh",2031007,3686,23.45,61.47,895,1248460,782547,1071772,959235,1645206
"Lalitpur","Uttar Pradesh",1221592,5039,24.94,63.52,906,775955,445637,640919,580673,977743
"Sant Kabir Nagar","Uttar Pradesh",1715183,1646,20.77,66.72,972,1144370,570813,869768,845415,1420206
"Basti","Uttar Pradesh",2464464,2688,18.21,67.22,963,1656613,807851,1255458,1209006,2084819
"Baghpat","Uttar Pradesh",1303048,1321,11.95,72.01,861,938325,364723,700187,602861,1163955
"Faizabad","Uttar Pradesh",2470996,2341,18.29,68.73,962,1698316,772680,1259427,1211569,2088931
"Mahoba","Uttar Pradesh",875958,3144,23.64,65.27,878,571738,304220,466431,409527,708475
"Mirzapur","Uttar Pradesh",2496970,4405,18.0,68.48,903,1709925,787045,1312123,1184847,2116076
"Firozabad","Uttar Pradesh",2498156,2407,21.69,71.92,875,1796674,701482,1332350,1165806,2052885
"Jalaun","Uttar Pradesh",1689974,4565,16.19,73.75,865,1246356,443618,906152,783822,1454492
"Kannauj","Uttar Pradesh",1656616,2093,19.27,72.7,879,1204360,452256,881648,774968,1388963
"Mathura","Uttar Pradesh",2547184,3340,22.78,70.36,863,1792199,754985,1367249,1179935,2074592
"Budaun","Uttar Pradesh",3681896,5168,19.95,51.29,871,1888444,1793452,1967876,1714020,3069526
"Kushinagar","Uttar Pradesh",3564544,2905,23.2,65.25,961,2325865,1238679,1817717,1746827,2893299
"Jaunpur","Uttar Pradesh",4494204,4038,14.89,71.55,1024,3215603,1278601,2220457,2273747,3911745
"Auraiya","Uttar Pradesh",1379545,2016,16.91,78.95,864,1089151,290394,740099,639446,1180006
"Gautam Buddha Nagar","Uttar Pradesh",1648115,1282,37.11,80.12,851,1320470,327645,890392,757723,1202039
"Kanshiram Nagar","Uttar Pradesh",1436719,1955,16.93,61.02,880,876686,560033,764212,672507,1228700
"Fatehpur","Uttar Pradesh",2632733,4152,14.05,67.43,901,1775252,857481,1384920,1247813,2308402
"Allahabad","Uttar Pradesh",5954391,5482,20.63,72.32,901,4306216,1648175,3132241,2822150,4936078
"Chitrakoot","Uttar Pradesh",991730,3216,29.43,65.05,879,645120,346610,527797,463933,766229
"Farrukhabad","Uttar Pradesh",1885204,2181,20.05,69.04,874,1301545,583659,1005979,879225,1570349
"Saharanpur","Uttar Pradesh",3466382,3689,19.66,70.49,890,2443453,1022929,1834065,1632317,2896859
"Maharajganj","Uttar Pradesh",2684703,2952,23.5,62.76,943,1684920,999783,1381731,1302972,2173849
"Etawah","Uttar Pradesh",1581810,2311,18.15,78.41,870,1240297,341513,845888,735922,1338815
"Mainpuri","Uttar Pradesh",1868529,2760,17.02,75.99,881,1419895,448634,993370,875159,1596760
"Bahraich","Uttar Pradesh",3487731,5237,46.48,49.36,892,1721544,1766187,1843410,1644321,2381029
"Bulandshahar","Uttar Pradesh",3499171,4512,20.12,68.88,896,2410229,1088942,1845554,1653617,2913063
"Ghazipur","Uttar Pradesh",3620268,3377,19.18,71.78,952,2598628,1021640,1854645,1765623,3037647
"Aligarh","Uttar Pradesh",3673889,3650,22.78,67.52,882,2480610,1193279,1952120,1721769,2992254
"Sonbhadra","Uttar Pradesh",1862559,6905,27.27,64.03,918,1192597,669962,971094,891465,1463471
"Varanasi","Uttar Pradesh",3676841,1535,17.15,75.6,913,2779692,897149,1922029,1754812,3138575
"Bijnor","Uttar Pradesh",3682713,4561,17.6,68.48,917,2521922,1160791,1921081,1761632,3131559
"Balrampur","Uttar Pradesh",2148665,3349,27.72,49.51,928,1063804,1084861,1114453,1034212,1682325
"Kaushambi","Uttar Pradesh",1599596,1779,23.7,61.28,908,980232,619364,838363,761233,1293125
"Jyotiba Phule Nagar","Uttar Pradesh",1840221,2249,22.76,63.84,910,1174797,665424,963466,876755,1499040
"Sultanpur","Uttar Pradesh",3797117,4436,18.11,69.27,983,2630263,1166854,1914835,1882282,3214899
"Banda","Uttar Pradesh",1799410,4408,17.05,66.67,863,1199667,599743,965867,833543,1537300
"Shahjahanpur","Uttar Pradesh",3006538,4388,18.0,59.54,872,1790093,1216445,1606057,1400481,2547914
"Mau","Uttar Pradesh",2205968,1713,18.98,73.09,979,1612342,593626,1114688,1091280,1854066
"Sant Ravidas Nagar","Uttar Pradesh",1578213,1015,16.58,68.97,955,1088494,489719,807270,770943,1353760
"Kheri","Uttar Pradesh",4021243,7680,25.38,60.56,894,2435265,1585978,2123148,1898095,3207244
"Hamirpur","Uttar Pradesh",1104285,4021,5.8,68.77,861,759417,344868,593383,510902,1043748
"Shrawasti","Uttar Pradesh",1117361,1640,-5.02,46.74,881,522255,595106,594025,523336,1176417
"Jhansi","Uttar Pradesh",1998603,5024,14.54,75.05,890,1499952,498651,1057462,941141,1744895
"Hardoi","Uttar Pradesh",4092845,5986,20.44,64.57,868,2642750,1450095,2191031,1901814,3398244
"Muzaffarnagar","Uttar Pradesh",4143512,4008,16.94,69.12,889,2863995,1279517,2193495,1950017,3543280
"Agra","Uttar Pradesh",4418797,4041,22.05,71.58,868,3162975,1255822,2365523,2053274,3620481
"Gorakhpur","Uttar Pradesh",4440895,3321,17.81,70.83,950,3145486,1295409,2277382,2163513,3769540
"Deoria","Uttar Pradesh",3100946,2540,14.31,71.13,1017,2205703,895243,1537405,1563541,2712751
"Unnao","Uttar Pradesh",3108367,4558,15.11,66.37,907,2063023,1045344,1629977,1478390,2700345
"Bareilly","Uttar Pradesh",4448359,4120,22.93,58.49,887,2601845,1846514,2357371,2090988,3618611
"Sitapur","Uttar Pradesh",4483992,5743,23.88,61.12,888,2740616,1743376,2374996,2108996,3619625
"Pratapgarh","Uttar Pradesh",3209141,3717,17.5,70.09,998,2249287,959854,1606177,1602964,2731184
"Ballia","Uttar Pradesh",3239774,2981,17.31,70.94,937,2298296,941478,1672573,1567201,2761720
"Barabanki","Uttar Pradesh",3260699,4402,21.96,61.75,910,2013482,1247217,1707172,1553527,2673581
"Kanpur Nagar","Uttar Pradesh",4581268,3155,9.92,79.65,862,3648980,932288,2460402,2120866,4167820
"Lucknow","Uttar Pradesh",4589838,2528,25.82,77.29,917,3547486,1042352,2394282,2195556,3647940
"Azamgarh","Uttar Pradesh",4613913,4054,17.11,70.93,1019,3272648,1341265,2285247,2328666,3939811
"Rampur","Uttar Pradesh",2335819,2367,21.42,53.34,909,1245926,1089893,1223583,1112236,1923751
"Ghaziabad","Uttar Pradesh",4681645,1179,42.27,78.07,881,3654960,1026685,2488913,2192732,3290676
"Moradabad","Uttar Pradesh",4772006,3718,25.22,56.77,906,2709068,2062938,2503676,2268330,3810898
"Etah","Uttar Pradesh",1774480,2431,13.62,70.81,873,1256509,517971,947400,827080,1561767
"Mahamaya Nagar","Uttar Pradesh",1564708,1840,17.12,71.59,871,1120174,444534,836295,728413,1335987
"Rae Bareli","Uttar Pradesh",3405559,4609,18.56,67.25,943,2290238,1115321,1752732,1652827,2872435
"Gonda","Uttar Pradesh",3433919,4003,24.17,58.71,921,2016054,1417865,1787568,1646351,2765498
"Meerut","Uttar Pradesh",3443689,2559,14.89,72.84,886,2508383,935306,1825922,1617767,2997379
"Chandauli","Uttar Pradesh",1952756,2541,18.83,71.48,918,1395830,556926,1018121,934635,1643319
"Siddharth Nagar","Uttar Pradesh",2559297,2895,25.45,59.25,976,1516383,1042914,1295191,1264106,2040093
"Uttarkashi","Uttarakhand",330086,8016,11.89,75.81,958,250238,79848,168583,161503,295009
"Dehradun","Uttarakhand",1696694,3088,32.33,84.25,902,1429465,267229,892058,804636,1282169
"Pithoragarh","Uttarakhand",483439,7090,4.58,82.25,1020,397629,85810,239326,244113,462267
"Tehri Garhwal","Uttarakhand",618931,3642,2.35,76.36,1077,472616,146315,297993,320938,604720
"Almora","Uttarakhand",622506,3144,-1.28,80.47,1139,500931,121575,291027,331479,630577
"Udham Singh Nagar","Uttarakhand",1648902,2542,33.45,73.1,920,1205347,443555,858803,790099,1235595
"Chamoli","Uttarakhand",391605,8030,5.74,82.65,1019,323662,67943,193960,197645,370347
"Bageshwar","Uttarakhand",259898,2241,4.18,80.01,1090,207944,51954,124353,135545,249470
"Champawat","Uttarakhand",259648,1766,15.63,79.83,980,207277,52371,131135,128513,224551
"Nainital","Uttarakhand",954605,4251,25.13,83.88,934,800723,153882,493591,461014,762891
"Pauri Garhwal","Uttarakhand",687271,5329,-1.41,82.02,1103,563700,123571,326805,360466,697100
"Haridwar","Uttarakhand",1890422,2360,30.63,73.43,880,1388137,502285,1005544,884878,1447158
"Rudraprayag","Uttarakhand",242285,1984,6.53,81.3,1114,196978,45307,114610,127675,227434
"Dakshin Dinajpur","West Bengal",1676276,2219,11.52,72.82,956,1220664,455612,856992,819284,1503117
"Birbhum","West Bengal",3502404,4545,16.15,70.68,956,2475499,1026905,1790595,1711809,3015415
"Bankura","West Bengal",3596674,6882,12.65,70.26,957,2527023,1069651,1837851,1758823,3192787
"Koch Bihar","West Bengal",2819086,3387,13.71,74.78,942,2108113,710973,1451641,1367445,2479189
"Murshidabad","West Bengal",7103807,5324,21.09,66.59,958,4730425,2373382,3628093,3475714,5866551
"Barddhaman","West Bengal",7717563,7024,11.92,76.21,945,5881555,1836008,3967899,3749664,6895607
"South Twenty Four Parganas","West Bengal",8161961,9960,18.17,77.51,956,6326336,1835625,4172782,3989179,6906965
"North Twenty Four Parganas","West Bengal",10009781,4094,12.04,84.06,955,8414222,1595559,5120093,4889688,8934114
"Kolkata","West Bengal",4496694,185,-1.67,86.31,908,3881097,615597,2356758,2139936,4573064
"Puruliya","West Bengal",2930115,6259,15.52,64.48,957,1889338,1040777,1497248,1432867,2536457
"Jalpaiguri","West Bengal",3872846,6227,13.87,73.25,953,2836860,1035986,1983024,1889822,3401112
"Darjiling","West Bengal",1846823,3149,14.77,79.56,970,1469332,377491,937474,909349,1609151
"Haora","West Bengal",4850029,1467,13.5,83.31,939,4040559,809470,2501304,2348725,4273153
"Purba Medinipur","West Bengal",5095875,4713,15.36,87.02,938,4434430,661445,2629450,2466425,4417367
"Maldah","West Bengal",3988845,3733,21.22,61.73,944,2462314,1526531,2051875,1936970,3290583
"Nadia","West Bengal",5167600,3927,12.22,74.97,947,3874150,1293450,2654135,2513465,4604883
"Hugli","West Bengal",5519145,3149,9.46,81.8,961,4514661,1004484,2814454,2704691,5042157
"Uttar Dinajpur","West Bengal",3007134,3140,23.15,59.07,939,1776314,1230820,1550868,1456266,2441847
"Paschim Medinipur","West Bengal",5913457,9368,13.86,78.0,966,4612496,1300961,3007862,2905595,5193621
